48,30,30,400,-300,0
01,  01,  01,  01,  01,  01,  01,  01,  01,  01,  01,  01,  01,  01,  01,  01,  01,  01,  01,  01,  01,  01,  01,  01,  01,  01,  01,  01,  01,  01,  01,  01,  01,  01,  01,  01,  01,  01,  01,  01,  01,  01,  01,  01,  01,  01,  01,  01,
01,  01,  01,  01,  01,  01,  01,  01,  01,  01,  01,  01,  01,  01,  01,  01,  01,  01,  01,  01,  01,  01,  01,  01,  01,  01,  01,  01,  01,  01,  01,  01,  01,  01,  01,  01,  01,  01,  01,  01,  01,  01,  01,  01,  01,  01,  01,  01,
01,  01,  01,  01,  01,  01,  01,  01,  01,  01,  01,  01,  01,  01,  01,  01,  01,  01,  01,  01,  01,  01,  01,  01,  01,  01,  01,  01,  01,  01,  01,  01,  01,  01,  01,  01,  01,  01,  01,  01,  01,  01,  01,  01,  01,  01,  01,  01,
01,  01,  01,  01,  01,  01,  01,  01,  01,  01,  01,  01,  01,  01,  01,  01,  01,  01,  01,  01,  01,  01,  01,  01,  01,  01,  01,  01,  01,  01,  01,  01,  01,  01,  01,  01,  01,  01,  01,  01,  01,  01,  01,  01,  01,  01,  01,  01,
01,  01,  01,  01,  01,  01,  01,  01,  01,  01,  01,  01,  01,  01,  01,  01,  01,  01,  01,  01,  01,  01,  01,  01,  01,  01,  01,  01,  01,  01,  01,  01,  01,  01,  01,  01,  01,  01,  01,  01,  01,  01,  01,  01,  01,  01,  01,  01,
01,  01,  01,  01,  01,  01,  01,  01,  01,  01,  01,  01,  01,  01,  01,  01,  01,  01,  01,  01,  01,  01,  01,  01,  01,  01,  01,  01,  01,  01,  01,  01,  01,  01,  01,  01,  01,  01,  01,  01,  01,  01,  01,  01,  01,  01,  01,  01,
01,  00,  00,  00,  00,  00,  00,  00,  00,  00,  00,  00,  00,  00,  00,  00,  00,  00,  00,  00,  00,  00,  00,  00,  00,  00,  00,  00,  00,  00,  00,  00,  00,  00,  00,  00,  00,  00,  00,  00,  00,  00,  00,  00,  00,  00,  00,  00,
01,  00,  00,  00,  00,  00,  00,  00,  00,  00,  00,  00,  00,  00,  00,  00,  00,  00,  00,  00,  00,  00,  00,  00,  00,  00,  00,  00,  00,  00,  00,  00,  00,  00,  00,  00,  00,  00,  00,  00,  00,  00,  00,  00,  00,  00,  00,  00,
01,  00,  00,  00,  00,  00,  00,  00,  00,  00,  00,  00,  00,  00,  00,  00,  00,  00,  00,  00,  00,  00,  00,  00,  00,  00,  00,  00,  00,  00,  00,  00,  00,  00,  00,  00,  00,  00,  00,  00,  00,  00,  00,  00,  00,  00,  00,  00,
01,  00,  00,  00,  00,  00,  00,  00,  00,  00,  00,  00,  00,  00,  00,  00,  00,  00,  00,  00,  00,  00,  00,  00,  00,  00,  00,  00,  00,  00,  00,  00,  00,  00,  00,  00,  00,  00,  00,  00,  00,  00,  00,  00,  00,  00,  00,  00,
01,  00,  00,  00,  00,  00,  00,  00,  00,  00,  00,  00,  00,  00,  00,  00,  00,  00,  00,  00,  00,  00,  00,  00,  00,  00,  00,  00,  00,  00,  00,  00,  00,  00,  00,  00,  00,  00,  00,  00,  00,  00,  00,  00,  00,  00,  00,  00,
01,  00,  00,  00,  00,  00,  00,  00,  00,  00,  00,  00,  00,  00,  00,  00,  00,  00,  00,  00,  00,  00,  00,  00,  00,  00,  00,  00,  00,  00,  00,  00,  00,  00,  00,  00,  00,  00,  00,  00,  00,  00,  00,  00,  00,  00,  00,  00,
01,  00,  00,  00,  00,  00,  00,  00,  00,  00,  00,  00,  00,  00,  00,  00,  00,  00,  00,  00,  00,  00,  00,  00,  00,  00,  00,  00,  00,  00,  00,  00,  00,  00,  00,  00,  00,  00,  00,  00,  00,  00,  00,  00,  00,  00,  00,  00,
01,  00,  00,  00,  00,  00,  00,  00,  00,  00,  00,  00,  00,  00,  00,  00,  00,  00,  00,  00,  00,  00,  00,  00,  00,  00,  00,  00,  00,  00,  00,  00,  00,  00,  00,  00,  00,  00,  00,  00,  00,  00,  00,  00,  00,  00,  00,  00,
01,  00,  00,  00,  00,  00,  00,  00,  00,  00,  00,  00,  00,  00,  00,  00,  00,  00,  00,  00,  00,  00,  00,  00,  00,  00,  00,  00,  00,  00,  00,  00,  00,  00,  00,  00,  00,  00,  00,  00,  00,  00,  00,  00,  00,  00,  00,  06,
01,  00,  00,  00,  03,  03,  00,  00,  03,  03,  00,  00,  03,  00,  03,  03,  00,  00,  03,  00,  00,  03,  00,  00,  03,  00,  00,  00,  03,  03,  00,  00,  03,  03,  00,  00,  03,  00,  00,  03,  00,  00,  03,  03,  03,  00,  00,  03,
01,  00,  00,  00,  00,  00,  00,  00,  00,  00,  00,  00,  00,  00,  00,  00,  00,  00,  00,  00,  00,  00,  00,  00,  00,  00,  00,  00,  00,  00,  00,  00,  00,  00,  00,  00,  00,  00,  00,  00,  00,  00,  00,  00,  00,  00,  00,  00,
01,  10,  10,  00,  00,  00,  00,  00,  00,  00,  00,  00,  00,  00,  00,  00,  00,  00,  00,  00,  00,  00,  00,  00,  00,  00,  00,  00,  00,  00,  00,  00,  00,  00,  00,  00,  00,  00,  00,  00,  00,  00,  00,  00,  00,  00,  00,  00,
01,  01,  01,  04,  04,  04,  04,  04,  04,  04,  04,  04,  04,  04,  04,  04,  04,  04,  04,  04,  04,  04,  04,  04,  04,  04,  04,  04,  04,  04,  04,  04,  04,  04,  04,  04,  04,  04,  04,  04,  04,  04,  04,  04,  04,  04,  04,  04,
01,  01,  01,  01,  01,  01,  01,  01,  01,  01,  01,  01,  01,  01,  01,  01,  01,  01,  01,  01,  01,  01,  01,  01,  01,  01,  01,  01,  01,  01,  01,  01,  01,  01,  01,  01,  01,  01,  01,  01,  01,  01,  01,  01,  01,  01,  01,  01,
01,  01,  01,  01,  01,  01,  01,  01,  01,  01,  01,  01,  01,  01,  01,  01,  01,  01,  01,  01,  01,  01,  01,  01,  01,  01,  01,  01,  01,  01,  01,  01,  01,  01,  01,  01,  01,  01,  01,  01,  01,  01,  01,  01,  01,  01,  01,  01,
01,  01,  01,  01,  01,  01,  01,  01,  01,  01,  01,  01,  01,  01,  01,  01,  01,  01,  01,  01,  01,  01,  01,  01,  01,  01,  01,  01,  01,  01,  01,  01,  01,  01,  01,  01,  01,  01,  01,  01,  01,  01,  01,  01,  01,  01,  01,  01,
01,  01,  01,  01,  01,  01,  01,  01,  01,  01,  01,  01,  01,  01,  01,  01,  01,  01,  01,  01,  01,  01,  01,  01,  01,  01,  01,  01,  01,  01,  01,  01,  01,  01,  01,  01,  01,  01,  01,  01,  01,  01,  01,  01,  01,  01,  01,  01,
01,  01,  01,  01,  01,  01,  01,  01,  01,  01,  01,  01,  01,  01,  01,  01,  01,  01,  01,  01,  01,  01,  01,  01,  01,  01,  01,  01,  01,  01,  01,  01,  01,  01,  01,  01,  01,  01,  01,  01,  01,  01,  01,  01,  01,  01,  01,  01,
01,  01,  01,  01,  01,  01,  01,  01,  01,  01,  01,  01,  01,  01,  01,  01,  01,  01,  01,  01,  01,  01,  01,  01,  01,  01,  01,  01,  01,  01,  01,  01,  01,  01,  01,  01,  01,  01,  01,  01,  01,  01,  01,  01,  01,  01,  01,  01,
01,  01,  01,  01,  01,  01,  01,  01,  01,  01,  01,  01,  01,  01,  01,  01,  01,  01,  01,  01,  01,  01,  01,  01,  01,  01,  01,  01,  01,  01,  01,  01,  01,  01,  01,  01,  01,  01,  01,  01,  01,  01,  01,  01,  01,  01,  01,  01,
01,  01,  01,  01,  01,  01,  01,  01,  01,  01,  01,  01,  01,  01,  01,  01,  01,  01,  01,  01,  01,  01,  01,  01,  01,  01,  01,  01,  01,  01,  01,  01,  01,  01,  01,  01,  01,  01,  01,  01,  01,  01,  01,  01,  01,  01,  01,  01,
01,  01,  01,  01,  01,  01,  01,  01,  01,  01,  01,  01,  01,  01,  01,  01,  01,  01,  01,  01,  01,  01,  01,  01,  01,  01,  01,  01,  01,  01,  01,  01,  01,  01,  01,  01,  01,  01,  01,  01,  01,  01,  01,  01,  01,  01,  01,  01,
01,  01,  01,  01,  01,  01,  01,  01,  01,  01,  01,  01,  01,  01,  01,  01,  01,  01,  01,  01,  01,  01,  01,  01,  01,  01,  01,  01,  01,  01,  01,  01,  01,  01,  01,  01,  01,  01,  01,  01,  01,  01,  01,  01,  01,  01,  01,  01,
01,  01,  01,  01,  01,  01,  01,  01,  01,  01,  01,  01,  01,  01,  01,  01,  01,  01,  01,  01,  01,  01,  01,  01,  01,  01,  01,  01,  01,  01,  01,  01,  01,  01,  01,  01,  01,  01,  01,  01,  01,  01,  01,  01,  01,  01,  01,  01,

