27,20,20,400,-300,0
01,  01,  01,  01,  01,  01,  01,  01,  01,  01,  01,  01,  01,  01,  01,  01,  01,  01,  01,  01,  01,  01,  01,  01,  01,  01,  01,
01,  01,  01,  01,  01,  01,  01,  01,  01,  01,  01,  01,  01,  01,  01,  01,  01,  01,  01,  01,  01,  01,  01,  01,  01,  01,  01,
01,  01,  01,  01,  01,  01,  01,  01,  01,  01,  01,  01,  01,  01,  01,  01,  01,  01,  01,  01,  01,  01,  01,  01,  01,  01,  01,
01,  01,  01,  01,  01,  01,  01,  01,  01,  01,  01,  01,  01,  01,  01,  01,  01,  01,  01,  01,  01,  01,  01,  01,  01,  01,  01,
01,  01,  01,  01,  01,  01,  01,  01,  01,  01,  01,  01,  01,  01,  01,  01,  01,  01,  01,  01,  01,  01,  01,  01,  01,  01,  01,
01,  01,  01,  01,  01,  01,  01,  01,  01,  01,  01,  01,  01,  01,  01,  01,  01,  01,  01,  01,  01,  01,  01,  01,  01,  01,  01,
01,  01,  01,  01,  01,  01,  01,  01,  01,  01,  01,  01,  01,  01,  01,  01,  01,  01,  01,  01,  01,  01,  01,  01,  01,  01,  01,
00,  00,  00,  00,  00,  00,  00,  00,  00,  00,  00,  00,  00,  00,  00,  00,  00,  00,  00,  00,  00,  00,  00,  00,  00,  01,  01,
00,  00,  00,  00,  00,  00,  00,  00,  00,  00,  00,  00,  00,  00,  00,  00,  00,  00,  00,  00,  00,  00,  00,  00,  00,  01,  01,
00,  00,  00,  00,  00,  00,  00,  00,  00,  00,  00,  00,  00,  00,  00,  00,  00,  00,  00,  00,  00,  00,  00,  00,  00,  01,  01,
00,  00,  00,  00,  00,  00,  00,  01,  01,  00,  00,  00,  00,  00,  00,  00,  00,  00,  00,  00,  00,  00,  00,  00,  00,  01,  01,
00,  00,  00,  00,  00,  00,  00,  07,  07,  00,  00,  00,  00,  00,  00,  00,  00,  00,  00,  00,  00,  00,  00,  00,  00,  01,  01,
00,  00,  00,  00,  00,  00,  00,  00,  00,  00,  00,  00,  00,  00,  00,  00,  00,  00,  06,  00,  00,  00,  00,  00,  00,  09,  01,
00,  00,  00,  00,  00,  00,  00,  00,  00,  00,  00,  00,  00,  00,  00,  00,  00,  00,  10,  10,  10,  00,  10,  00,  00,  09,  01,
00,  00,  00,  00,  00,  00,  10,  10,  10,  00,  00,  00,  00,  00,  00,  00,  00,  00,  00,  00,  00,  00,  00,  00,  00,  09,  01,
00,  00,  00,  00,  00,  10,  01,  00,  00,  00,  00,  00,  00,  00,  00,  00,  00,  00,  00,  00,  00,  00,  00,  00,  10,  01,  01,
00,  00,  00,  00,  10,  01,  08,  00,  00,  00,  00,  00,  00,  00,  00,  00,  00,  00,  00,  00,  00,  00,  00,  10,  01,  01,  01,
10,  10,  10,  10,  01,  01,  01,  10,  10,  10,  10,  10,  10,  00,  00,  10,  00,  00,  10,  10,  10,  10,  00,  01,  01,  01,  01,
01,  01,  01,  01,  01,  01,  01,  01,  01,  01,  01,  01,  01,  04,  04,  01,  04,  04,  01,  01,  01,  01,  04,  01,  01,  01,  01,
01,  01,  01,  01,  01,  01,  01,  01,  01,  01,  01,  01,  01,  01,  01,  01,  01,  01,  01,  01,  01,  01,  01,  01,  01,  01,  01,
