27,50,30,400,-300,0
01,  01,  01,  01,  01,  01,  01,  01,  01,  01,  01,  01,  01,  01,  01,  01,  01,  01,  01,  01,  01,  01,  01,  01,  01,  01,  01,
01,  01,  01,  01,  01,  01,  01,  01,  01,  01,  01,  01,  01,  01,  01,  01,  01,  01,  01,  01,  01,  01,  01,  01,  01,  01,  01,
01,  01,  01,  01,  01,  01,  01,  01,  01,  01,  01,  01,  01,  01,  01,  01,  01,  01,  01,  01,  01,  01,  01,  01,  01,  01,  01,
01,  01,  01,  01,  01,  01,  01,  01,  01,  01,  01,  01,  01,  01,  01,  01,  01,  01,  01,  01,  01,  01,  01,  01,  01,  01,  01,
01,  01,  01,  01,  01,  01,  01,  01,  01,  01,  01,  01,  01,  01,  01,  01,  01,  01,  01,  01,  01,  01,  01,  01,  01,  01,  01,
01,  01,  01,  01,  01,  01,  01,  01,  01,  01,  01,  01,  01,  01,  01,  01,  01,  01,  01,  01,  01,  01,  01,  01,  01,  01,  01,
01,  01,  01,  01,  01,  01,  01,  01,  01,  01,  01,  01,  01,  01,  01,  01,  01,  01,  01,  01,  01,  01,  01,  01,  01,  01,  01,
01,  00,  00,  00,  00,  00,  00,  00,  00,  00,  00,  00,  00,  00,  00,  00,  00,  00,  00,  00,  00,  00,  00,  00,  00,  01,  01,
01,  00,  00,  00,  00,  00,  00,  00,  00,  00,  00,  00,  00,  00,  00,  00,  00,  00,  00,  00,  00,  00,  00,  00,  00,  01,  01,
01,  00,  00,  00,  00,  00,  00,  00,  00,  00,  00,  00,  00,  00,  00,  00,  00,  00,  00,  00,  00,  00,  00,  00,  00,  01,  01,
01,  00,  00,  00,  00,  00,  00,  01,  01,  00,  00,  00,  00,  00,  00,  00,  00,  00,  00,  00,  00,  00,  00,  00,  00,  01,  01,
01,  00,  00,  00,  00,  00,  00,  101,  101,  00,  00,  00,  00,  00,  00,  00,  00,  00,  00,  00,  00,  00,  00,  00,  00,  01,  01,
01,  00,  00,  00,  00,  00,  00,  00,  00,  00,  00,  00,  00,  00,  00,  00,  00,  00,  00,  00,  00,  00,  00,  00,  00,  103,  01,
01,  00,  00,  00,  00,  00,  00,  00,  00,  00,  00,  00,  00,  00,  00,  00,  00,  00,  00,  00,  00,  00,  00,  00,  00,  103,  01,
01,  00,  00,  00,  00,  00,  04,  04,  04,  00,  00,  00,  00,  00,  00,  00,  00,  00,  00,  00,  00,  00,  00,  00,  00,  103,  01,
01,  00,  00,  00,  00,  04,  01,  00,  00,  00,  00,  00,  00,  00,  00,  00,  00,  00,  00,  00,  00,  00,  00,  00,  00,  103,  01,
01,  00,  00,  00,  04,  01,  102,  00,  00,  00,  00,  00,  00,  00,  00,  00,  00,  00,  00,  00,  00,  00,  00,  00,  00,  103,  01,
01,  04,  04,  04,  01,  01,  01,  03,  03,  03,  03,  03,  03,  00,  00,  03,  00,  00,  04,  04,  04,  04,  04,  00,  00,  103,  01,
01,  01,  01,  01,  01,  01,  01,  01,  01,  01,  01,  01,  01,  100,  100,  01,  100,  100,  01,  01,  01,  01,  102,  00,  00,  103,  01,
01,  01,  01,  01,  01,  01,  01,  01,  01,  01,  01,  01,  01,  01,  01,  01,  01,  01,  01,  01,  01,  01,  102,  00,  00,  103,  01,
01,  01,  01,  01,  01,  01,  01,  01,  01,  01,  01,  01,  01,  01,  01,  01,  01,  01,  01,  01,  01,  01,  102,  00,  00,  103,  01,
01,  01,  01,  01,  01,  01,  01,  01,  01,  01,  01,  01,  01,  01,  01,  01,  01,  01,  01,  01,  01,  01,  102,  00,  00,  103,  01,
01,  01,  01,  01,  01,  01,  01,  01,  01,  01,  01,  01,  01,  01,  01,  01,  01,  01,  01,  01,  01,  01,  102,  00,  00,  103,  01,
01,  01,  01,  01,  01,  01,  01,  01,  01,  01,  01,  01,  01,  01,  01,  01,  01,  01,  01,  01,  01,  01,  102,  00,  00,  103,  01,
01,  01,  01,  01,  01,  01,  01,  01,  01,  01,  01,  01,  01,  01,  01,  01,  01,  01,  01,  01,  01,  01,  102,  00,  00,  103,  01,
01,  01,  01,  01,  01,  01,  01,  01,  01,  01,  01,  01,  01,  01,  01,  01,  01,  01,  01,  01,  01,  01,  102,  00,  00,  103,  01,
01,  01,  01,  01,  01,  01,  01,  01,  01,  01,  01,  01,  01,  01,  01,  01,  01,  01,  01,  01,  01,  01,  102,  00,  00,  103,  01,
01,  01,  01,  01,  01,  01,  01,  01,  01,  01,  01,  01,  01,  01,  01,  01,  01,  01,  01,  01,  01,  01,  102,  00,  00,  103,  01,
01,  01,  01,  01,  01,  01,  01,  01,  01,  01,  01,  01,  01,  01,  01,  01,  01,  01,  01,  01,  01,  01,  102,  00,  00,  103,  01,
01,  01,  01,  01,  01,  01,  01,  01,  01,  01,  01,  01,  01,  01,  01,  01,  01,  01,  01,  01,  01,  01,  00,  00,  00,  103,  01,
01,  101,  101,  101,  101,  101,  101,  101,  101,  101,  101,  101,  101,  101,  101,  101,  101,  101,  101,  101,  101,  101,  00,  00,  00,  103,  101,
01,  00,  00,  00,  00,  00,  00,  00,  00,  00,  00,  00,  00,  00,  00,  00,  00,  00,  00,  00,  00,  00,  00,  00,  00,  103,  01,
01,  00,  00,  03,  03,  03,  03,  03,  03,  03,  03,  03,  03,  03,  03,  03,  04,  04,  04,  04,  04,  04,  04,  00,  304,  103,  01,
01,  00,  00,  01,  01,  01,  01,  01,  01,  01,  01,  01,  01,  01,  01,  01,  01,  01,  01,  01,  01,  01,  01,  01,  01,  01,  01,
01,  00,  00,  01,  01,  01,  01,  01,  01,  01,  01,  01,  01,  01,  01,  01,  01,  01,  01,  01,  01,  01,  01,  01,  01,  01,  01,
01,  00,  00,  01,  01,  01,  01,  01,  01,  01,  01,  01,  01,  01,  01,  01,  01,  01,  01,  01,  01,  01,  01,  01,  01,  01,  01,
01,  00,  00,  01,  01,  01,  01,  01,  01,  01,  01,  01,  01,  01,  01,  01,  01,  01,  01,  01,  01,  01,  01,  01,  01,  01,  01,
01,  00,  00,  01,  01,  01,  01,  01,  01,  01,  01,  01,  01,  01,  01,  01,  01,  01,  01,  01,  01,  01,  01,  01,  01,  01,  01,
01,  00,  00,  01,  01,  01,  01,  01,  01,  01,  01,  01,  01,  01,  01,  01,  01,  01,  01,  01,  01,  01,  01,  01,  01,  01,  01,
01,  00,  00,  00,  00,  00,  00,  00,  00,  00,  00,  00,  00,  00,  00,  00,  00,  00,  00,  00,  00,  00,  00,  00,  01,  01,  01,
01,  00,  00,  00,  00,  00,  00,  00,  00,  00,  00,  00,  00,  00,  00,  00,  00,  00,  00,  00,  00,  00,  00,  00,  01,  01,  01,
01,  00,  00,  00,  00,  00,  00,  00,  00,  00,  00,  00,  00,  00,  00,  00,  00,  00,  00,  00,  00,  00,  00,  00,  01,  01,  01,
01,  00,  00,  00,  00,  00,  00,  00,  00,  00,  00,  00,  00,  00,  00,  00,  00,  00,  00,  00,  00,  00,  00,  00,  01,  01,  01,
01,  00,  00,  00,  00,  00,  00,  00,  00,  00,  00,  00,  00,  00,  00,  00,  00,  00,  00,  00,  00,  00,  00,  306,  01,  01,  01,
01,  00,  00,  00,  00,  00,  00,  00,  00,  00,  00,  00,  00,  00,  00,  00,  00,  00,  00,  00,  00,  00,  00,  03,  01,  01,  01,
01,  00,  00,  00,  00,  00,  00,  00,  00,  00,  00,  00,  00,  00,  00,  00,  00,  00,  00,  03,  00,  03,  00,  00,  01,  01,  01,
01,  00,  00,  00,  00,  00,  00,  00,  00,  00,  00,  00,  03,  00,  03,  00,  03,  00,  03,  00,  00,  00,  00,  00,  01,  01,  01,
01,  01,  01,  00,  03,  00,  03,  00,  03,  00,  03,  00,  00,  00,  00,  00,  00,  00,  00,  00,  00,  00,  00,  00,  01,  01,  01,
01,  01,  01,  100,  100,  100,  100,  100,  100,  100,  100,  100,  100,  100,  100,  100,  100,  100,  100,  100,  100,  100,  100,  100,  01,  01,  01,
01,  01,  01,  01,  01,  01,  01,  01,  01,  01,  01,  01,  01,  01,  01,  01,  01,  01,  01,  01,  01,  01,  01,  01,  01,  01,  01,
