27,50,30,400,-300,0
01,  01,  01,  01,  01,  01,  01,  01,  01,  01,  01,  01,  01,  01,  01,  01,  01,  01,  01,  01,  01,  01,  01,  01,  01,  01,  01,
01,  01,  01,  01,  01,  01,  01,  01,  01,  01,  01,  01,  01,  01,  01,  01,  01,  01,  01,  01,  01,  01,  01,  01,  01,  01,  01,
01,  01,  01,  01,  01,  01,  01,  01,  01,  01,  01,  01,  01,  01,  01,  01,  01,  01,  01,  01,  01,  01,  01,  01,  01,  01,  01,
01,  01,  01,  01,  01,  01,  01,  01,  01,  01,  01,  01,  01,  01,  01,  01,  01,  01,  01,  01,  01,  01,  01,  01,  01,  01,  01,
01,  01,  01,  01,  01,  01,  01,  01,  01,  01,  01,  01,  01,  01,  01,  01,  01,  01,  01,  01,  01,  01,  01,  01,  01,  01,  01,
01,  01,  01,  01,  01,  01,  01,  01,  01,  01,  01,  01,  01,  01,  01,  01,  01,  01,  01,  01,  01,  01,  01,  01,  01,  01,  01,
01,  01,  01,  01,  01,  01,  01,  01,  01,  01,  01,  01,  01,  01,  01,  01,  01,  01,  01,  01,  01,  01,  01,  01,  01,  01,  01,
01,  00,  00,  00,  00,  00,  00,  00,  00,  00,  00,  00,  00,  00,  00,  00,  00,  00,  00,  00,  00,  00,  00,  00,  00,  01,  01,
01,  00,  00,  00,  00,  00,  00,  00,  00,  00,  00,  00,  00,  00,  00,  00,  00,  00,  00,  00,  00,  00,  00,  00,  00,  01,  01,
01,  00,  00,  00,  00,  00,  00,  00,  00,  00,  00,  00,  00,  00,  00,  00,  00,  00,  00,  00,  00,  00,  00,  00,  00,  01,  01,
01,  00,  00,  00,  00,  00,  00,  01,  01,  00,  00,  00,  00,  00,  00,  00,  00,  00,  00,  00,  00,  00,  00,  00,  00,  01,  01,
01,  00,  00,  00,  00,  00,  00,  07,  07,  00,  00,  00,  00,  00,  00,  00,  00,  00,  00,  00,  00,  00,  00,  00,  00,  01,  01,
01,  00,  00,  00,  00,  00,  00,  00,  00,  00,  00,  00,  00,  00,  00,  00,  00,  00,  00,  00,  00,  00,  00,  00,  00,  09,  01,
01,  00,  00,  00,  00,  00,  00,  00,  00,  00,  00,  00,  00,  00,  00,  00,  00,  00,  00,  00,  00,  00,  00,  00,  00,  09,  01,
01,  00,  00,  00,  00,  00,  10,  10,  10,  00,  00,  00,  00,  00,  00,  00,  00,  00,  00,  00,  00,  00,  00,  00,  00,  09,  01,
01,  00,  00,  00,  00,  10,  01,  00,  00,  00,  00,  00,  00,  00,  00,  00,  00,  00,  00,  00,  00,  00,  00,  00,  00,  09,  01,
01,  00,  00,  00,  10,  01,  08,  00,  00,  00,  00,  00,  00,  00,  00,  00,  00,  00,  00,  00,  00,  00,  00,  00,  00,  09,  01,
01,  10,  10,  10,  01,  01,  01,  10,  10,  10,  10,  10,  10,  00,  00,  10,  00,  00,  10,  10,  10,  10,  10,  00,  00,  09,  01,
01,  01,  01,  01,  01,  01,  01,  01,  01,  01,  01,  01,  01,  04,  04,  01,  04,  04,  01,  01,  01,  01,  08,  00,  00,  09,  01,
01,  01,  01,  01,  01,  01,  01,  01,  01,  01,  01,  01,  01,  01,  01,  01,  01,  01,  01,  01,  01,  01,  08,  00,  00,  09,  01,
01,  01,  01,  01,  01,  01,  01,  01,  01,  01,  01,  01,  01,  01,  01,  01,  01,  01,  01,  01,  01,  01,  08,  00,  00,  09,  01,
01,  01,  01,  01,  01,  01,  01,  01,  01,  01,  01,  01,  01,  01,  01,  01,  01,  01,  01,  01,  01,  01,  08,  00,  00,  09,  01,
01,  01,  01,  01,  01,  01,  01,  01,  01,  01,  01,  01,  01,  01,  01,  01,  01,  01,  01,  01,  01,  01,  08,  00,  00,  09,  01,
01,  01,  01,  01,  01,  01,  01,  01,  01,  01,  01,  01,  01,  01,  01,  01,  01,  01,  01,  01,  01,  01,  08,  00,  00,  09,  01,
01,  01,  01,  01,  01,  01,  01,  01,  01,  01,  01,  01,  01,  01,  01,  01,  01,  01,  01,  01,  01,  01,  08,  00,  00,  09,  01,
01,  01,  01,  01,  01,  01,  01,  01,  01,  01,  01,  01,  01,  01,  01,  01,  01,  01,  01,  01,  01,  01,  08,  00,  00,  09,  01,
01,  01,  01,  01,  01,  01,  01,  01,  01,  01,  01,  01,  01,  01,  01,  01,  01,  01,  01,  01,  01,  01,  08,  00,  00,  09,  01,
01,  01,  01,  01,  01,  01,  01,  01,  01,  01,  01,  01,  01,  01,  01,  01,  01,  01,  01,  01,  01,  01,  08,  00,  00,  09,  01,
01,  01,  01,  01,  01,  01,  01,  01,  01,  01,  01,  01,  01,  01,  01,  01,  01,  01,  01,  01,  01,  01,  08,  00,  00,  09,  01,
01,  01,  01,  01,  01,  01,  01,  01,  01,  01,  01,  01,  01,  01,  01,  01,  01,  01,  01,  01,  01,  01,  00,  00,  00,  09,  01,
01,  01,  01,  01,  01,  01,  01,  01,  01,  01,  01,  01,  01,  01,  01,  01,  01,  01,  01,  01,  01,  01,  00,  00,  00,  09,  01,
01,  00,  00,  00,  00,  00,  00,  00,  00,  00,  00,  00,  00,  00,  00,  00,  00,  00,  00,  00,  00,  00,  00,  00,  00,  09,  01,
01,  00,  00,  03,  03,  03,  03,  03,  03,  03,  03,  03,  03,  03,  03,  03,  03,  03,  03,  03,  03,  03,  03,  00,  05,  09,  01,
01,  00,  00,  01,  01,  01,  01,  01,  01,  01,  01,  01,  01,  01,  01,  01,  01,  01,  01,  01,  01,  01,  01,  01,  01,  01,  01,
01,  00,  00,  01,  01,  01,  01,  01,  01,  01,  01,  01,  01,  01,  01,  01,  01,  01,  01,  01,  01,  01,  01,  01,  01,  01,  01,
01,  00,  00,  01,  01,  01,  01,  01,  01,  01,  01,  01,  01,  01,  01,  01,  01,  01,  01,  01,  01,  01,  01,  01,  01,  01,  01,
01,  00,  00,  01,  01,  01,  01,  01,  01,  01,  01,  01,  01,  01,  01,  01,  01,  01,  01,  01,  01,  01,  01,  01,  01,  01,  01,
01,  00,  00,  01,  01,  01,  01,  01,  01,  01,  01,  01,  01,  01,  01,  01,  01,  01,  01,  01,  01,  01,  01,  01,  01,  01,  01,
01,  00,  00,  01,  01,  01,  01,  01,  01,  01,  01,  01,  01,  01,  01,  01,  01,  01,  01,  01,  01,  01,  01,  01,  01,  01,  01,
01,  00,  00,  00,  00,  00,  00,  00,  00,  00,  00,  00,  00,  00,  00,  00,  00,  00,  00,  00,  00,  00,  00,  00,  01,  01,  01,
01,  00,  00,  00,  00,  00,  00,  00,  00,  00,  00,  00,  00,  00,  00,  00,  00,  00,  00,  00,  00,  00,  00,  00,  01,  01,  01,
01,  00,  00,  00,  00,  00,  00,  00,  00,  00,  00,  00,  00,  00,  00,  00,  00,  00,  00,  00,  00,  00,  00,  00,  01,  01,  01,
01,  00,  00,  00,  00,  00,  00,  00,  00,  00,  00,  00,  00,  00,  00,  00,  00,  00,  00,  00,  00,  00,  00,  00,  01,  01,  01,
01,  00,  00,  00,  00,  00,  00,  00,  00,  00,  00,  00,  00,  00,  00,  00,  00,  00,  00,  00,  00,  00,  00,  06,  01,  01,  01,
01,  00,  00,  00,  00,  00,  00,  00,  00,  00,  00,  00,  00,  00,  00,  00,  00,  00,  00,  00,  00,  00,  00,  03,  01,  01,  01,
01,  00,  00,  00,  00,  00,  00,  00,  00,  00,  00,  00,  00,  00,  00,  00,  00,  00,  00,  03,  00,  03,  00,  00,  01,  01,  01,
01,  00,  00,  00,  00,  00,  00,  00,  00,  00,  00,  00,  03,  00,  03,  00,  03,  00,  03,  00,  00,  00,  00,  00,  01,  01,  01,
01,  01,  01,  00,  03,  00,  03,  00,  03,  00,  03,  00,  00,  00,  00,  00,  00,  00,  00,  00,  00,  00,  00,  00,  01,  01,  01,
01,  01,  01,  04,  04,  04,  04,  04,  04,  04,  04,  04,  04,  04,  04,  04,  04,  04,  04,  04,  04,  04,  04,  04,  01,  01,  01,
01,  01,  01,  01,  01,  01,  01,  01,  01,  01,  01,  01,  01,  01,  01,  01,  01,  01,  01,  01,  01,  01,  01,  01,  01,  01,  01,
